advantage=перевага
among=серед
amongst=серед
ankle=щиколотка
barely=ледве
bewitched=зачарований
book=книга
breast=груди
budge=рухатися
but=але
by-and-by=незабаром
cheerful=веселий
come=прийти
confidence=впевненість
considerable=значний
crawl=повзати
crawled in=заповзти
crawled=повзли
crawling=повзання
creeping=повзучий
cure=вилікувати
disturbance=ґвалт
down-hearted=пригнічений
down=вниз
dull=нудний
fence=паркан
fidgety=непосидючий
funeral=похорон
gap=діра
goggles=окуляри
grave=могила
grieving=сумуючи
harm=шкода
harp=арфа
her=її
horseshoe=підкова
hung=висіти
itch=свербіж
itching=сверблячий
just=якраз
kept pecking=продовжувати клювати
likely=ймовірно
limb=сучок
lit=освітлений
lonesome=самотній
mad=божевільний
maid=діва
middling=середній
miserableness=халепа
mournful=скорботний
nailing=забивання цвяхів
niggers=негри
plenty=багато
prayers=молитви
quality=якість
reckoned=рахувався
rode=катався
ruined=занапащений
rustled=зашелестів
saddle-boils=сідловини
scared=наляканий
scrambled out=видряпався
scratch=подряпина
scrunch=скручувати
servant=слуга
she=вона
shed=сарай
shivers=тремтіння
shriveled=зморщений
sister=сестра
slid=ковзали
slim=стрункий
slip=ковзати
slipped=стягнув
snap=хруснути
so=так
soon=скоро
spelling-book=буквар
spelling=правопис
spread=поширення
stiller=тихіший
sweat=піт
there=там
tied=прив'язаний
tiptoeing=навшпиньки
tired=втомився
tiresome=втомливий
tolerable=стерпний
towards=назустріч
twig=гілочка
whisper=шепотіти
whooing=гукання
wicked=грішний
widow's=вдови
widow=вдова,прикуп
witches=відьми
